# Vocabulary for Korean

=== Skill 0 - Alphabet_1 ===


Lesson 1[]


Lesson 2[]


Lesson 3[]

이 – i = this/two

Lesson 4[]


Lesson 5[]


Lesson 6[]


=== Skill 1 - Alphabet_2 ===


Lesson 1 []


Lesson 2 []


Lesson 3 []


Lesson 4 []


Lesson 5 []


=== Skill 2 - Alphabet_3 ===


Lesson 1[]

서울 (seoul) = Seoul

Lesson 2[]


Lesson 3[]

대구(daegu) = Daegu

=== Skill 3 - Belongings ===


Lesson 1[]

아기 (agi) = baby
우유 (uyu) = milk
오이 (oi) = cucumber
어 (eo) = oh
이 (i) = this, the

Lesson 2[]

여우 (yeou) = fox
아이 (ai) = child
아 (a) = ah
예 (ye) = yes
위 (wi) = on, above
와 (wa) = wow
요요 (yoyo) = yoyo

Lesson 3[]

개미 (gaemi) = ant
학생 (haksaeng) = student
닭 (dak) = chicken
신문 (sinmun) = newspaper
메시지 (mesiji) = message
노래 (norae) = song

Lesson 4[]

열쇠 (yeolsoe) = key
서울 (seoul) = Seoul
도넛 (doneot) = doughnut, donut
맛 (mat) = flavor, taste
입구 (ipgu) = entrance

=== Skill 4 - Borrowings ===


Lesson 1[]

시카고 (sikago) = Chicago
필라델피아 (pilladelpia) = Philadelphia
보스턴 (bosteon) = Boston
피츠버그 (picheubeogeu) = Pittsburgh
프린스턴 (peulinseuteon) = Princeton

Lesson 2[]

아이스크림 (aiseukeulim) = ice cream
콜라 (kolla) = cola
커피 (keopi) = coffee
듀오링고 (dyuolinggo) = Duolingo
파리 (pali) = Paris
아파트 (apateu) = apartment

Lesson 3[]

아이스 (aiseu) = ice
티 (ti) = tea
키 (ki) = key
아메리카노 (amelicano) = americano
모니터 (moniteo) = monitor
폰 (pon) = phone

Lesson 4[]

골드 (gold) = gold
다이아몬드 (daiamond) = diamond
헤어 (heeo) = hair
실버 (silbeo) = silver
화이트 (hwaiteu) = white
블랙 (beullaek) = black

Lesson 5[]

파티 (pati) = party
텔레비전 (tellebijeon) = television
베를린 (beleullin) = Berlin
펜실베이니아 (pensilbenia) = Pennsylvania
도쿄 (dokyo) = Tokyo

=== Skill 5 - And ===


Lesson 1[]

쓰레기 (sseulegi) = trash
바지 (baji) = pants
삼성 (samseong) = Samsung
현대 (hyeondae) = Hyundai
그 (geu) = that

Lesson 2[]

카메라 (kamela) = camera
런던 (leondeon) = London
워싱턴 (wosingteon) = Washington
부산 (busan) = Busan
까마귀 (kkamagwi) = crow
테이프 (teipeu) = tape

Lesson 3[]

두부 (dubu) = tofu
뉴욕 (nyuyok) = New York
씨 (ssi) = seed
저 (jeo) = that (over there)
밖 (bak) = outside

Lesson 4[]

밭 (bat) = field
꽃 (kkot) = flower
잎 (ip) = leaf
입 (ip) = mouth
알 (al) = egg

Lesson 5[]

밥 (bap) = rice
닭갈비 (dakgalbi) = Dakgalbi
별 (byeol) = star
각막 (gakmak) = cornea
뽀뽀 (ppoppo) = kiss
낮 (nat) = daytime

=== Skill 6 - Greetings ===


Lesson 1[]

김서준 (gimseojun) = Seojun Kim
이가람 (igalam) = Garam Lee
이민지 (iminji) = Minji Lee
박지훈 (bakjihun) = Jijun Park
김선화 (gimseonhwa) = Seonhwa Kim
최 (choe) = Choi
성 (seong) = last name

Lesson 2[]

안녕 (annyeong) = hi/bye (informal)
안녕하세요 (annyeonghaseyo) = hello (polite)
안녕하십니까 (anyeonghasimnikka) = hello (formal)
만나서 반갑습니다 (mannaseo bangapseumnida) = nice to meet you
저 (jeo) = I, me
제 (je) = my = 저의

Lesson 3[]

씨 (ssi) = Mr., Ms., Mrs. ... (formal)
요즘 (yojeum) = lately, nowadays
잘 (jal) = well
지냅니다 (jinaemnida) = to live, to spend time
지내십니까? (jinaesimnikka) = to live, to spend time (question form) (formal)
어떻게 (eotteoke) = how

Lesson 4[]

안녕히 가세요 (annyeonghi gaseyo) = Goodbye (say to somebody going)
안녕히 계세요 (annyeonghi gaseyo) = Goodbye, Stay in peace (say to somebody staying)
죄송합니다 (juisonghamnida) = sorry (formal)
처음 뵙겠습니다 (ceoeum boepgetseumnida) = Nice to meet you (for the first time)
고맙습니다 (gomapseumnida) = thank you (formal)

=== Skill 7 - Basics ===


Lesson 1[]

여자 (yeoja) = woman
남자 (namja) = man
일합니다 (ilhamnida) = to work
일합니까? (ilhamnikka) = to work (question form)
전화 (jeonhwa) = phone
전화합니다 (jeonhwahamnida) = to call
공부합니다 (gongbuhamnida) = to study
공부합니까? (gongbuhamnikka) = to study (question form)
지금 (jigeum) = now
잡니다 (jamnida) = to sleep
잡니까? (jamnikka) = to sleep (question form)

Lesson 2[]

고양이 (goyangi) = cat
개 (gae) = dog
좋습니다 (joseumnida) = to be good, to like
나쁩니다 (nappeumnida) = to be bad
큽니다 (keumnida) = to be big
작습니다 (jakseumnida) = to be small

Lesson 3[]

빠릅니다 (ppareumnida) = to be fast
느립니다 (neurimnida) = to be slow
우리 (uri) = we
이야기합니다 (iyagihamnida) = to speak, to talk
얘기합니다 (yaegihamnida) = to speak, to talk
운동합니다 (undonghamnida) = to work out, to exercise
오늘 (oneul) = today

Lesson 4[]

사과 (sagwa) = apple
연필 (yeonpil) = pencil
책 (chaek) = book
빵 (bbang) = bread
있습니다 (itseumnida) = to have, to be
친구 (chingu) = friend
그 (geu) = he
그들 (geudeul) = they

Lesson 5[]

가족 (gajok) = family
음식 (eumsik) = food
돈 (don) = money
공 (gong) = ball
그녀 (geunyeo) = she
그녀들 (geunyeodeul) = they
없습니다 (eopseumnida) = to not have, to be not

Lesson 6[]

영화 (yeonghwa) = movie
게임 (geim) = game
맛있습니다 (masitseumnida) = to be delicious
맛없습니다 (mateopseumnida) = to taste bad
재미있습니다 (jaemiitseumnida) = to be fun, to be interesting
재미없습니다 (jaemieopseumnida) = to be not fun, to be uninteresting
멋있습니다 (meosisseumnida) = to be cool
멋없습니다 (meoteopseumnida) = to be not cool
맛있는 (masitneun) = to be delicious

=== Skill 8 - Intro ===


Lesson 1[]

미국 (miguk) = USA
일본 (ilbon) = Japan
중국 (jungguk) = China
영국 (yeongguk) = UK
네 (ne) = yes
음식 (eumsik) = food
미국 음식 (miguk eumsik) = American food
일본 음식 (ilbon eumsik) = Japanese food
중국 음식 (jungguk eumsik) = Chinese food
사람 (saram) = person
미국 사람 (miguk saram) = American (person)
일본 사람 (ilbon saram) = Japanese (person)
중국 사람 (jungguk saram) = Chinese (person)
도 (do) = too, also, as well

Lesson 2[]

프랑스 (prangseu) = France
브라질 (brajil) = Brazil
선생님 (seonsaengnim) = teacher
의사 (uisa) = doctor
출신 (chulsin) = origin/birth
출신입니다 (chulsinimnida) = to be from
한국 출신입니다 (hanguk chulsinimnida) = to be from Korea
프랑스 출신입니다 (prangseu chulsinimnida) = to be from France
인 (in) = person
미국인 (migukin) = American (person)
일본인 (ilbonin) = Japanese (person)
중국인 (junggukin) = Chinese (person)
전 (jeon) = I am (short for 저는)

Lesson 3[]

태국 (taeguk) = Thailand
태국 사람 (taeguk saram) = 태국인 (taegukin) = Thai (person)
인도 (indo) = India
인도 사람 (indo saram) = 인도인 (indoin) = Indian (person)
호주 (hoju) = Australia
호주 사람 (hoju saram) = 호주인 (hojuin) = Australian (person)
회사원 (hoesawon) = office worker
이/가 아닙니다 (animnida) = to be not
전 서울 출신이 아닙니다 = I am not from Seoul
저는 의사가 아닙니다 = I am not a doctor
아니요 (aniyo) = No

Lesson 4[]

가수 (gasu) = singer
경찰 (gyeongchal) = police officer
배우 (baeu) =  actor/actress
남아공 (namagong) = South Africa
남아공 사람 (namagong saram) = South African (person)
이집트 (ijipteu) = Egypt
이집트 사람 (ijipteu saram) = Egyptian (person)

=== Skill 9 - Motion ===


Lesson 1[]

집 (jip) = home, house
학교  (hakgyo) = school
에 (e) = to
갑니다 (gamnida) = to go
같이 (gachi) = together

Lesson 2[]

식당 (sikdang) = restaurant
화장실 (hwajangsil) = bathroom
회사 (hoesa) = company
노래방 (noraebang) = karaoke
에서 (eseo) = from
옵니다 (omnida) = to come

Lesson 3[]

공부합니다 (gongbuhamnida) = to study
걷습니다 (geotseumnida) = to walk
에스컬레이터 (eseukeolleiteo) = escalator
에서 (eseo) = in, at, on
까지 (kkaji)= to
시장 (sijang) = market
손님 (sonnim)= customer, guest

Lesson 4[]

여자아이 (yeojaai) = girl
남자아이 (namjaai) = boy
병원 (byeongwon) = hospital
달립니다 (dalrimnida) = to run
운동장 (undongjang) = playground
여자애 (yeojaae) = girl
남자애 (namjaae) = boy
으로/로  (euro/ro) = toward
어떻게  (etteoke) = how

=== Skill 10 - Sit/Stand ===


Lesson 1[]

가방 = bag
나무 = tree
책상 = desk
바다 = ocean, sea
산 = mountain
공원 = park
알 = egg

Lesson 2[]

도서관 = library
의자 = chair
침대 = bed
자동차 = car
바닥 = floor
앉다 = to sit

Lesson 3[]

길 = road, street
방 = room
탁자 = table
줄 = line
줄 서! = line up!
서다 = to stand
벤치 = bench

Lesson 4[]

우체국 = post office
섬 = island
교실 = classroom
눕다 = to lie
대학교 = university

=== Skill 11 - Food ===


Lesson 1[]

바나나 = banana
오렌지 = orange
과일 = fruit
먹다 = to eat
야채 = vegetables
라면 = ramen, instant noodle (normally Korean one)

Lesson 2[]

와인 = wine
마시다 = to drink
맥주 = beer
주스 = juice
물 = water
조금 = a little
밀크셰이크 = milk shake
차 = tea
음료 = drink, beverage

Lesson 3[]

토마토 = tomato
딸기 = Strawberry
비싸다 = to be expensive
싸다 =  to be cheap
수프 = soup
햄버거 = hamburger
사다 = to buy

Lesson 4[]

생선 = fish
계란 = egg
달걀 = egg
불고기 = Bulgogi
김밥 = Kimbab
팔다 = to sell
차갑다 = to be cold
뜨겁다 = to be hot

=== Skill 12 - Adjectives ===


Lesson 1[]

귀엽다 = to be cute
예쁘다 = to be pretty
더럽다 = to be dirty
깨끗하다 = to be clean
여자 친구 = girlfriend
남자 친구 = boyfriend

Lesson 2[]

안 = not
아름답다 = to be beautiful
튼튼하다 = to be tough, healthy, strong, solid
뚱뚱하다 = to be fat
날씬하다 = to be thin
바쁘다 = to be busy

Lesson 3[]

똑똑하다 = to be smart
착하다 = to be nice, good-hearted
게으르다 = to be lazy
키 = height
키가 크다 = to be tall
키가 작다 = to be short
용감하다 = to be brave
아프다 = to be sick, ill

Lesson 4[]

매력적이다 = to be charming, attractive
성실하다 = to be sincere, hardworking, faithful
친절하다 = to be kind-hearted, friendly
솔직하다 = to be honest
이기적이다 = to be selfish
안전하다 = to be safe
안전 = safety

=== Skill 13 - Action ===


Lesson 1[]

읽다 = to read
쓰다 = to write
기사 = article
서점 = bookstore
카페 = cafe
편지 = letter

Lesson 2[]

수영 = swimming
수영하다 = to swim
수영장 = swimming pool
기숙사 = dormitory
배우다 = to learn
독서실 = study room
학원 = hagwon, cram school

Lesson 3[]

기다리다 = to wait
로비 = lobby
저희 = we
순서 = turn, order
노래를 부르다 = to sing a song

Lesson 4[]

차다 (chada)= to kick
점프 (jeompeu) = jump
점프하다 ( jeompeu hada )= to jump
하품 (hapumda) = yawning
졸리다 ( jollida ) = to be sleepy
재미가 있다 = 재미있다 = to be fun, interesting

=== Skill 14 - Here/There ===


Lesson 1[]

가볍습니다 = to be light
재미없습니다 = to be boring
건물 = building
무겁습니다 = heavy
적습니다 = few
많이 = many
많습니다 = to be many/lots of
이것 = this one
그것 = that one
저것 = that one (over there)

Lesson 2[]

여기 = here/this place
거기 = there/that place
저기 = over there/that place (over there)
춥습니까 = cold
호텔 = hotel
덥습니까 = hot

Lesson 3[]

여기까지 = so far/till here
쪽 = way
이쪽 = this way
그쪽 = that way
아니면 = or
저쪽 = that way (over there)
V+(어/아)야 하다 = to have to/should (do something)

=== Skill 15 - Language ===


Lessons[]


Lesson 1[]

베트남어 = Vietnamese
말합니다 = to speak
한국어로 = in Korean
얘기합니다 = to talk
독일어로 = in German
독일인 = German
언어 = language
한글 = Hangeul
멋있습니다 = to be cool
적습니다 = to write
러시아어로 = in Russian
대화합니다 = to converse
생각합시다 = to think
생각 = thought
대화 = conversation

Lesson 3[]

어려워 = hard
쉬워요 = easy
쉽습니다 = to be easy
말 = speech
맞습니까 = to be right
단어 = word
어렵습니다 = to be difficult
매일 = every day
함께 = together

=== Skill 16 - Animals ===


Lesson 1[]


Lesson 2[]


Lesson 3[]


Lesson 4[]


Lesson 5[]


=== Skill 17 - Questions ===


Lesson 1[]

왜 = why
언제 = when
어디에서 = where from
무슨 = which
어떻게 = how
어디 = where
누구 = who

Lesson 2[]

무엇 = what
어떤 = what kind of
어느 = which one
누가 = who

=== Skill 18 - Action_2 ===


Lesson 1[]

춥니다 = to dance
춤 = dance
시작하십시오 = to start
잠 = sleep
춤춥니다 = to dance
천천히 = slowly
시작 = begining
집중합니까 = to concentrate
인사합니다 = to greet
꿈 = dream
꿉니다 = to dream
인사 = greetings
집중합니까 = to concentrate
인사합니다 = to greet
꿈 = dream
꿉니다 = to dream
인사 = greetings

=== Skill 19 - Polite ===



=== Skill 20 - Meals ===



=== Skill 21 - Colors ===



=== Skill 22 - Numbers_1 ===

사람 한 명이 있어요 = There is one person

=== Skill 23 - Daily_Life ===


Lesson 1[]

밤 (bam) = Night
시 (si) = Time/Hour (As in o’clock)
새벽 (saebyeok) = Dawn/Daybreak/Morning
깨다 (ireonada) = To wake up/To regain consciousness
반 (ban) = Half
청소 (cheongso) = Cleanliness
청소하다(cheongsohada) = To clean

Lesson 2[]

오후 (ohu) = Afternoon/P.M.
오전 (ojeon) = Morning/A.M.
닦다 (dakda) = To wipe
그래서 (geuraeseo) = So
시간 (sigan) = Hour(s)/Time
동안 (dongan) = For/During/While
~서 (~seo) = And then/And so

=== Skill 24 - Family ===



=== Skill 25 - Clothing ===



=== Skill 26 - Seasons ===


Lesson 1[]

봄 = spring
풀 = grass
펴 = bloom
흘러 = flow
흘러요 = flows
푸른 = green/blue
사계절 = four seasons
새끼 = baby
벚꽃은 = cherry blossoms

Lesson 2[]

해 = sun
햇빛 = sunlight
지냈어요 = spent
떠요 = float/floats
떴어요 = floated
여름 = summer
황사 = yellow dust

Lesson 3[]

낙엽 = fallen leaf/fallen leaves
수확물 = crops
가을 = fall/autumn
떨어져요 = falls
풍부해요 = plenty
호박 = pumpkins
긁어요 = scratches
바람 = breeze
긁습니다 = rake/rakes

Lesson 4[]

불 = fire
겨울 = winter
타고 = burning
눈이 와요 = snowing/it snows
난로 = stove
얼음 = ice
스키를 타요 = skis
스키 = ski

=== Skill 27 - Numbers_2 ===

공 / 영 = 0
일 = 1
이 = 2
삼 = 3
사 = 4
오 = 5
육 = 6
In North Korea, 6 = 륙. The "ㄹ" is lost in South Korea and replaced by "ㅇ". However, a ghost of the "ㄹ" still remains. e.g.- 16 = 십육 is pronounced as "심육" due to the deleted "ㄹ".
In North Korea, 6 = 륙. The "ㄹ" is lost in South Korea and replaced by "ㅇ". However, a ghost of the "ㄹ" still remains. e.g.- 16 = 십육 is pronounced as "심육" due to the deleted "ㄹ".
칠 = 7
팔 = 8
구 = 9
십 = 10
백 = 100
천 = 1.000 (thousand)
만 = 10.000 (ten thousand)
십만 = 100.000 (hundred thousand; lit.ten ten thousand)
백만 = 1.000.000 (million; lit. hundred ten thousand)
천만 = 10.000.000 (ten million; lit. thousand ten thousand)
억 = 100.000.000 (hundred million)
십억 = 1.000.000.000 (billion; lit. ten hundred million)
조 = 1.000.000.000.000 (trillion)
만이천삼백십 = 12310 (10.000 + 2*1.000 + 3*100 + 10)
돈 = money
달러 = dollar
번호 = number

=== Skill 28 - Time ===


Lesson 1[]

초 = second
분 = minute
시간 = hour/time
새벽 = dawn
밤 = night
오전 = a.m./morning
오후 = p.m./afternoon
시 = hour/time (as in "o'clock")

Lesson 2[]

그저께 = the day before yesterday
어제 = yesterday
어젯밤 = last night
모레 = day after tomorrow
며칠 = a few days
옛날 = the old days

Lesson 3[]

동안 = for/while/during
걸려요 = take (time)
지난번 = last time
다음에 = next time
이번 = this time
마지막 = last
주 = week

Lesson 4[]

달 = month
날 = day
년 = year
해 = year
일 = day
작년 = last year
올해 = this year
매년 = every year
내년 = next year
지난달 = last month

Lesson 5[]

하루 = one day
이틀 = two days
사흘 = three days
나흘 = four days
닷새 = five days
엿새 = six days

Lesson 6[]

이레 = seven days
여드레 = eight days
아흐레 = nine days
열흘 = ten days
오늘부터 = starting today
주일 = week

=== Skill 29 - Modifier_2 ===


Lesson 1[]

간 = who has gone
온 적이 없어요 = has never been
마신 = who drank
먹은 = having eaten

Lesson 2[]

본 = that...saw
받은 = which...received
선 = who stood
뚱뚱하던 = who used to be fat
꿈을 꾼 = who had a dream
준 = which...gave

=== Skill 30 - Future ===


Lesson 1[]

할 것입니다 = will
갈 것입니다 = will go
올 = will come
마실 것입니다 = will drink
먹을 = time
고향 = hometown

Lesson 2[]

보내줄 = will send
걸을 거예요 = will walk
볼 거다 = will see
만들 = will make
들을 것입니까? = will hear?
예정이에요 = planning to
내일 볼 = to be read tomorrow
예정 = schedule

Lesson 3[]

가르칠 것입니다 = will teach
쓸 것이에요 = will write
가실 것입니다 = will go
보낼 것입니까? = will send?
있을 것입니다 = will be
없을 거예요 = there will not be
숨을 거예요 = will hide
만날 시간이 = time to meet
잡지 않을 것이에요 = will not catch

=== Skill 31 - Adverbs_1 ===



=== Skill 32 - Casual ===



=== Skill 33 - Hobbies ===

취미 = hobby
롤러스케이트를 타는 것이 = rollerskating
스케이트보드 타는 것이 = skateboarding
서핑 = surfing
그릴 = draw
낚시하는 = fishing ..
야구공 = baseball
참 = truly
수수께끼 = riddle
퍼즐 = puzzle
푸는지 = solve
지는지 = lose
이기는 걸 = to win
죽음 = death
때문에 = because of
수 있다 = to can
수 있어 = can
할 수 없다 = cannot do
찰 수 없는 = that cannot be kicked
줄 알다 = to know how to
줄 압니까 = know how
줄 알아요 = know how
운전할 줄 아세요 = do you know how to drive
어디에서 낚시할 수 있는지를 압니까 = do you know where we can fish
그릴 줄 모르는 남자 = man that cannot (lacks the know-how to) draw

=== Skill 34 - Body ===


Lesson 1[]

코 = nose
머리 = head
얼굴 = face
입 = mouth
눈 = eye
귀 = ear
이 = tooth
머리카락 = hair
아파요 = hurts

Lesson 2[]

등 = back
피부 = skin
가슴 = chest/heart
몸 = body
뼈 = bone
어깨뼈 = shoulder blade
허리 = waist
어깨 = shoulder
넓어요 = broad/wide

Lesson 3[]

팔꿈치 = elbow
다리 = legs
팔 = arm
무릎 = knee
손가락 = finger
발가락 = toe
발꿈치 = heel
발 = foot
무릎 = lap

Lesson 4[]

콧수염 = mustache
수염 = beard
손바닥 = palm
발바닥 = sole
눈물 = tears
배꼽 = belly button
손톱 = fingernail
발톱 = toenails
바닥 = floor

Lesson 5[]

촉각 = sense of touch
후각 = sense of smell
청각 = sense of hearing
미각 = sense of taste
시각 = sense of sight
감각 = sense

=== Skill 35 - Phrases_2 ===


Lesson 1[]

천만에요 = you're welcome
위하여 = cheers to that
생일 = birthday
생신 = birthday
축하해 = happy (informal)
축하드립니다 = happy (honorific form)
축하합니다 = happy (formal, polite)
건배 = cheers (when toasting)
부탁해요 = favor
부탁했어요 = asked a favor
제발 = please
처음 뵙겠습니다 = Nice to meet you (for the first time)
인사 = Greeting
인사합니다 = To greet
안녕히 주무세요 = Good night
나중에 = Later / Afterwards
나중에 뭐 해 = What will you do later?
오랜만이에요 = Long time no see ( I haven't seen you for a while)
어떻게 지냈어요 = How have you been?
조금 이따가 봬요 = See you in a little while
그냥 = Just
아싸 = Alright! / Oh yeah!
아이고 = Oh no / Oops / Oh my gosh
파이팅 = Fighting! (Good luck / You got this!)
대박 = Awesome
우아 = Wow
진짜 = Really (in a questioning way)

=== Skill 36 - City ===


Lesson 1[]

뉴욕 시 = New York City
도시 = city
수도 = capital
복잡하다 = crowded
복잡해요 = crowded
시내 = downtown
교외 = suburbs
교외에 = in the suburbs
동네에 = neighborhood

Lesson 2[]

다리 = bridge
횡단보도 = crosswalk
건너요 = cross
건너서 = after crossing
터널에 = in the tunnel
들어가세요 = go in
혼잡해 = overcrowded
혼잡해요 = overcrowded
혼잡했어요 = it was overcrowded
지나가는 사람은 = passerby
터널로 = through the tunnel
지나고 싶은데 = want to go through
들어갔어요 = entered
좁아 = narrow

Lesson 3[]

경찰서 = police station
백화점을 = department store
편의점에 = convenience store
고층 = high-rise
시청 = city hall
소방서 = fire station
마천루 = skyscraper

=== Skill 37 - Written ===

손 = hands
전화 = phone
택시 = taxi
병 = bottle
문 = door
얻다 = to obtain / get / gain
받다 = to receive / get
타다 = to take
주문하다 = to order
일어나다 = to get up
일어나라! = get up!
일어서다 = to stand up
일어선다 = stands up
일어서니 = do ... stand up?
씻다 = to wash
씻는다 = washes
씻으세요 = wash
사용하다 / 쓰다 = to use
사용한다 = uses
쉬다 = to rest
쉬어라! = rest!
쉬니 = do ... rest?
닫다 = to close
닫아라! = close!
닫니 = ... closes ...?
소리 = sound
소리를 지르다 = to scream
소리지른다 = screams
소리를 지르지 않는다 = does not scream
운전하다 = to drive
운전하느냐 = does ... drive?
있다 = to be / to have
있는다 = formal, non-polite indicative present tense
있습니다 = formal, polite indicative present tense
있어 = informal, non-polite indicative present tense
있어요 = informal, polite indicative present tense

=== Skill 38 - Cooking ===

뇌 = brain
배추 = napa cabbage
양배추 = cabbage
양파 = onion
식용이 = for consumption / edible
식용유로 = cooking oil
요리법 = recipe
따르면 = according to
따르세요 = follow
젓다 = to stir
저으세요 = stir
자르세요 = cut
구우세요 = bake
구워주세요 = grill / roast
넣으세요 = put / add
솓가락 = spoon
젓가락 = chopsticks
칼로 = knife
도마 = cutting board
전자레인지 = microwave
오븐 = oven
찌세요 = steam
삶다 = to boil (food in liquid, then discard the water: eggs)
끓다 = to boil (a liquid: water/milk)
끓이다 = to boil (food in liquid and keep the water: noodles)
시끄럽게 = noisily
위한 = for
복숭아 = peach
고구마 = sweet potato
무 = radish
소스 = sauce
단 = sweet
익히다 = to cook
정육점 = butcher's shop
조리대 = kitchen counter
국자 = ladle/scoop
휴지통 = trash can
근처에 = nearby
맛이 나요 = tastes like
것 같아요 = it seems
안맞아요 = does not fit
좀 = a little
뚜껑 = lid
냄비 = pot
국물 = broth (lit: soup water)
만두 = dumpling
간장 = soy sauce
양념 = seasoning
배달하다 = to deliver
배달 할 것입니다 = will deliver
잔치 = party
떡 = rice cakes
찌개 = stew
오이 = cucumber
오이무침 = cucumber salad
파무침 = green onion salad
무무침 = seasoned radish
계란찜 = steamed egg
닭찜 = braised chicken
갈비찜 = braised short ribs
먹어야 합니다 = have to eat

=== Skill 39 - Home ===


Lesson 3[]

가스 = gas
잠그세요 = turn off
냉장고 = fridge/refridgerator
냉동고 = freezer
식기 = dishes
주방 = kitchen
가스레인지 = gas stove

Lesson 4[]

싱크대 = sink
건조해요 = dry
욕실 = bathroom
식기세척기 = dishwasher
세탁기 = washing machine
고장 났어요 = broken
건조기 = dryer
청소하자 = let's clean
청소기 = vacuum cleaner

Lesson 5[]

자물쇠 = lock
울타리 = fence
차고 = garage
마당 = yard
정원 = garden
지붕 = roof

=== Skill 40 - Jobs ===

직업 = job
직장 = workplace
출장 = business trip
경력 = career / work experience
노동자 = worker
고용주 = employer
고용인 = employee
실업자 = unemployed person
퇴직 = retirement
취직하다 = to get a job
실직하다 = to lose a job
해고하다 = to fire someone
해고되다 = to be fired
출근하다 = to go to work
근무하다 = to work
퇴근하다 = to finish work
퇴직을 하다 = to retire
건축 = construct
건축가 = architect
예술 = art
예술가 = artist
제빵 = baking
제빵사 = baker
의사 = doctor
감독 = director
엔지니어 = engineer
변호 = defense
변호사 = lawyer
모델 = model
화가 = painter
조종사 = pilot
군 = military
군인 = soldier
작가 = writer
대통령 = the President
이미 = already
벌써 = already
적이 있어요 = I have done/experienced it
적이 없어요 = I have not done/experienced it
한 적이 없어요 = I have never done it

=== Skill 41 - Sports ===

스포츠= Sports
응원하다= To cheer (for)
코치= Coach
경기= Match/game
감독님= Manager
골= Goal
선수= Player/athlete
득점을 하다= To score
공격수= Attacker
수비수= Defender
경기장= Stadium
하키= Hockey
축구단= Football club
하키장= Hockey rink
배구= Volleyball
네트= Net
탁구= Table Tennis
테니스= Tennis
채= Racket
코트= Court
농구= Basketball
농구장= Basketball Court
양궁= Archery
쏘다= To shoot (e.g. a gun)
활= Bow
화살= Arrow
도장= The Dojo
대권도 선수 = Taekwondo Practitioner
궁수= Archer
경주= Race
용품= Equipment
훈련장= Training Field
마라톤= Marathon
승마= Horseback Riding
바둑= Baduk
수영장= Swimming Pool
권투= Boxing
선수= Player

=== Skill 42 - Shopping ===

시장 = market
슈퍼마겟 = supermarket
가게 = store
서점 = bookstore
백화점 = department store
장바구니 = shopping basket
카트 = cart
쇼핑하러 가다 = to go to shop
할인 중이에요 = it is on sale
할인 할 때 = when it is on sale
판매 중이에요 = it is for sale
가격 = price
가치 = value
가치가 있다 = it is valuable
가치가 없다 = it is worthless
퍼센트 = percent
유로 = euro
새 / 새로운 = new
식료품 = food products / groceries
제품 = product
상표 = brand
탈의실 = fitting room
줄 = row / queue / line / cord / string
현금 = cash
신용카그 = credit card
계산서 = bill
계산대 = checkout
지불하다 / 계산하다 = to pay
영수증 = receipt
교환 = exchange
교환이 안 돼요 = cannot be exchanged
교환학생 = exchange student

=== Skill 43 - Verbal_Adjectives ===

일반적 = general/normal
기본적 = basic
구체적 = specific
근본적 = fundamental
역사적 = historical
적극적 = enthousiastic
긍정적인 = optimistic/positive
부정적인 = pessimistic/negative
위협적인= menacing
전통 =  tradition
이론 = theory

=== Skill 44 - Yard ===



=== Skill 45 - Age ===



=== Skill 46 - Weather ===

비= Rain
태풍= Typhoon
강하다= To be strong
칼=Sword
무지개= Rainbow
안개= Fog
폭풍= Storm
추천하다= To recommend
계절= Season
바람= Wind
불다= To blow
홍수가 나다= To flood
그림자= Shadow
우박= Hail
서리= Frost
빛= Light
눈보라= Blizzard
가뭄= Drought
주의하다= To mind/watch out/beware
홍수 주의보= Flood warning
젖다= To get wet
젖었다= Got wet
한파= Cold snap
기후= Climate
도= Degree
열기= Heat
온도계= Thermometer
온도= Temperature
맑다= To be clear
습하다= To be humid
끼다= To hang
밝다= To be bright
불빛= Lights
구금= Clouds
천둥= Thunder
예보관= Weather forecaster
대통령= The President
친다= To strike
번개= Lightning
일기 예보= Weather report/forecast
예보하다= To make a forecast
일기 예보관= Weather reporter

=== Skill 47 - School ===

유치원 = kindergarten
초등학교 = primary/elementary school
초등학생 = primary/elementary school student
중학교 = middle school
중학생 = middle school student
고등학교 = high school
고등학생 = high school student
교장 선생님 = school principal
담임 선생님 = homeroom teacher
수학여행 = school trip
운동장 = playground
학년 = grade
반 = class/homeroom
학급 명부 = class roster
숙제 = homework
시험 = test
교시 = period
삼교시 = third period
졸업 = graduation
성적표 = report card
점수 = score
만점 = perfect score
빵점 = zero points
분필 = chalk
칠판 = blackboard
자리 = seat
교실 = classroom
강당 = auditorium
체육관 = gym
발표하다 = to present

=== Skill 48 - Medicine ===

건강 = health
감기 = cold
바이러스 = virus
진단 = diagnosis
코피 = nosebleed
심장 = heart
마비 = paralysis
심장마비 = heart attack
고통 = pain/agony
고통을 받아요 = suffers from pain
낳았어요 = gave birth
죽음 = death
사망한 사람 = the person who died
치료하고 있어요 = are treating
치료가 어렵습니다 = is difficult to treat
약 = medicine
약국 = pharmacy
약사 = pharmacist
약을 복용하다 = to take medicine
감기약 = cold medicine
환자 = patient
간호사 = nurse
외과 = department of surgery
외과의사 = surgeon
뇌 = brain
뇌외과 의사 = brain surgeon
수술 = surgery
수술대 = operating table
메스 / 수술칼 = scalpel
치과 = dentist
치과학 = dentistry
내과학 = internal medicine
소아과 = paediatrics
소아과 의사 = paediatrician

=== Skill 49 - Bathroom ===

물을 틀다 = to turn on the water
욕조 = bathtub
목욕하는 = someone who bathes
목욕탕 = bathhouse
샤워 = shower
변기 = toilet
샴푸 = shampoo
비누 = soap
수건 = towel
치약 = toothpaste
칫솔 = toothbrush
머리를 감다 = to wash hair
젖은 […] = wet […]
빗 = comb
면도하다 = to shave
면도기 = razor
가위 = scissors
머리를 깎다 = to cut hair

=== Skill 50 - Emergency ===

비상 = emergency
비상 사태 = emergency situation
긴급 사태 = urgent situation
긴급한 = urgent
구급차 = ambulance
구급상자 = first aid kit
구급대원 = emergency worker
훈련 = training
도움 = help
지도 = map
불러요 = to call
경찰 = police
상태 = condition
신고 = report
신고하다 = to report
당하다 = to experience
신고를 당했습니다 = was reported
도독 = thief
도난 = theft
도난 당했습니다 = was robbed
발생하다 = to happen
무슨 일이 발생했어요 = what happened
소방차 = fire engine
소방관 = fire fighter
소화기 = fire extinguisher
불을 끈다 = to put out the fire
불을 꺼요 = turn off the light
불 = fire (flame)
화재 = fire (uncontrolled burning)
진압하다 = to suppress

=== Skill 51 - Travel ===

공항 = airport
비행기 = plane
비행 중인 = that is flying/in flight
수하물 = luggage
짐 = baggage
탑승권 = boarding pass
탑승 수속 = check-in / boarding procedure
탑승하다 = to board
항공사 = airline
출발하다 = to depart
도착하다 = to arrive
안내하다 = to guide
안내원 = guide
안내서 = guidebook
방문하다 = to visit
면세점 = duty free shop
모험 = adventure
세관 = customs
때때 = sometimes
여권 = passport
온도 = temperature
예매하다 = to book
예매권 = advance ticket
영화표 = movie ticket
입국 카드 = landing card
기록하다 = to record
출국 기록 = departure record
출국 비자 = exit visa
신청하다 = to apply
비자 신청 = visa application
연장하다 = to extend

=== Skill 52 - Map ===

지구본 = globe
세계 = world
대륙 = continent
국가 = country/nation
국경 = border
언어 = language
탐험하다 = to explore
호주 = australia
아시아 = asia
중국 = china
일본 = japan
싱가포르 = singapore
태국 = thailand
터키 = turkey
[..]-인 = person from country
[..]-어 = language
체코 = czech republic
그리스 = greece
이스라엘 = israel
폴란드 = poland
포르투갈 = portugal
루마니아 = romania
러시아 = russia
외국 = foreign
벨기에 = belgium
덴마크 = denmark
프랑스 = france
독일 = germany
아일랜드 = ireland
네덜란드 = netherlands
노르웨이 = norway
스페인 = spain
영국 = the UK
아르헨티나 = argentina
브라질 = brazil
이집트 = egypt
멕시코 = mexico
페루 = peru
서유럽 = western europe
북쪽 = north
동쪽 = east
남쪽 = south
서쪽 = west
동서남복 = east, west, south, north

=== Skill 53 - Olympics ===

평창 = Pyeongchang
평창 동계 올림픽 = Pyeongchang Winter Olympics
개최하다 = to host
개최 도시 = host city
제이십삼 회 = the twenty-third
제 is a prefix for sino-Korean ordinal numbers (like the 번째 suffix for native Korean ordinals)
회 is a suffix indicating a specific event in a series, roughly means a "meeting" or "round"
마스코트 = mascot
국제 공항 = international airport
선수단 = squad (lineup)
오륜 = Olympic rings (literally means five wheels/rings)
국가 대표 팀 = national team
대표 = representative
대표 = representative
스노보드 = snowboard
봅슬레이 = bobsled/bobsleigh
스피드 스케이팅 선수 = speed skater
피겨 선수 = figure skater
쇼트트랙 선수 = short track skater
성화 = torch
개막식 = opening ceremony
폐막식 = closing ceremony
시상식 = awards ceremony
상 = award
경기장 = stadium
수상자 = winner
메달 = medal
동메달 = bronze medal
은메달 = silver medal
금메달 = gold medal
따다 = to win (get, receive, obtain, etc.)
땄습니다 (formal past conjugation)
받다 = to receive
받았습니다 (formal past conjugation)

