# Vocabulary for Chinese

=== Skill 0 - Greeting_1 ===


Lesson 1[]

你 (nǐ) = you
好 (hǎo) = good
你好 (nǐ hǎo) = hello (lit. "you good")

Lesson 2[]

再 (zài) = again
见 (jiàn) = see
再见 (zài jiàn) = goodbye

=== Skill 1 - Numbers ===


Lesson 1[]

我 (wǒ) = I
叫 (jiào = call/called
一 (yī) = one
三 (sān) = three
七 (qī) = seven
八 (bā) = eight

Lesson 2[]

零 (líng) = zero
十 (shí) = ten
元 (yuán) = yuan (chinese currency)

Lesson 3[]

五 (wǔ) = five
九 (jiǔ) = nine
百 (bǎi) = hundred

Lesson 4[]

二 (èr) = two
四 (sì) = four
六 (liù) = six

=== Skill 2 - Name ===


Lesson 1[]

我 (wǒ) = I/me/my
叫 (jiào) = called/call
你叫 (nǐ jiào) = you are/your name is
叫我 (jiào wǒ) = I am
我叫 (wǒ jiào) = my name is
李 = Li name)
华 = Hua (name)
张 = Zhang (name)
明 = Ming (name)

Lesson 2[]

什 (shén) = what
么 (me) = what
什么 (shén me) = what/what is
名 (míng) = name
字 (zì) = word
名字 (míng zì) = first name

Lesson 3[]

姓 (xìng) = last name
王 (wáng) = Wang (name)
呢 (ne) = what about/how about (interrogative)
你呢 (nǐ ne) = and yours, what's yours

=== Skill 3 - Greeting_2 ===


Lesson 1[]

高 (gāo) = tall/high
兴 (xìng) = prosper/rise/prevail/become popular
高兴 (gāoxìng) = happy
很 (hěn) = very/really

Lesson 2[]

认 (rèn) = recognize/know/make out/identify
识 (shí) = knowledge; know/understand/grasp
认识 (rènshì) = meet/know/recognise
也 (yě) = also/too

=== Skill 4 - Food_1 ===


Lesson 1[]

吃 (chī) = eat
饭 (fàn) = rice
鱼 (yú) = fish
面 (miàn) = noodles

Lesson 2[]

不 (bù) = do not/does not
喝 (hē) = drink
茶 (chá) = tea
水 (shuǐ) = water

=== Skill 5 - Occupation ===


Lesson 1[]

学 (xué) = to learn/to study/to imitate
生 (shēng) = student/raw/uncooked
学生 (xué shēng) = student
他 (tā) = he/his
是 (shì) = is/are

Lesson 2[]

吗 (ma) = interrogative i.e. question word = "?"
们 (men) = plural marker e.g. 他们 (tā men) = they (male), or 我们 (wǒ men) = we/our
她 (tā) = she/her

Lesson 3[]

老 (lǎo) = prefix to do with order of birth or affection
师 (shī) = master/expert/surname
老师 (lǎo shī) = teacher
医 (yī) = medical/medicine/docture/to cure
医生 (yī shēng) = doctor

=== Skill 6 - Contact ===


Lesson 1[]

电 (diàn) = electric/eletricity/electrical
话 (huà) = speech/voice/spoken words
电话 (diàn huà) = phone/telephone
的 (de) = genitive marker (i.e. possession) - of/ 's

Lesson 2[]

多 (duō) = much/many/often/more
少 (shǎo) = few/less/to lack/to stop
多少 (duō shǎo) = what/what's (talking about numbers)
号 (hào) = roar/ordinal number/day of the month/mark
码 (mǎ) = numbers/weight/classifier for length
号码 (hào mǎ) = number/numbers

=== Skill 7 - Nation ===


Lesson 1[]

人 (rén) = person
中 (zhōng) = centre/middle
国 (guó) = country
中国 (zhōng guó) = China
中国人 (zhōng guó rén) = Chinese person

Lesson 2[]

哪 (nǎ) = which/where
英 (yīng) = petal/petal/flower/leaf/England
英国 (yīng guó) = the United Kingdom/British
美 (měi) = beautiful/pleasing
美国 (měi guó) = America/American

Lesson 3[]

加 (jiā) = plus/increase
拿 (ná) = which
大 (dà) = big/large/great
加拿大 (jiā ná dà) = Canadian
大人 (dà rén) = adult
都 (dōu) = both/all
对 (duì) = yes/right/correct

=== Skill 8 - Greeting_3 ===


Lesson 1[]

早 (zǎo) = morning; early/in advance/beforehand
上 (shàng) = come up/ascend; upper/higher/better
早上 (zǎo shàng) = morning
忙 (máng) = busy
早上好 (zǎo shang hǎo) = good morning

Lesson 2[]

样 (yàng) = appearance/shape/look/form
怎 (zěn) = why/how
么 (me) = suffix interrogative
怎么样 (zěn me yàng) = how/how are things?
今 (jīn) = modern/present-day; now/the present
天 (tiān) = period of time in a day; sky/heaven; day
今天 (jīn tiān) = today

=== Skill 9 - Location_1 ===


Lesson 1[]

北 (běi) = north/to be defeated (classical)
京 (jīng) = big/capital
北京 (běi jīng) = Beijing
在 (zài) =  -at/in/on/tobe (in))
家 (jiā) = home/house

Lesson 2[]

纽 (niǔ) = to turn/to wrench
约 (yuē) = pact/agreement
纽约 (niǔ yuē) = New York
香 (xiāng) = fragrent/sweet smelling
港 (gǎng) = harbour/port
香港 (xiāng gǎng) = Hong Kong
儿 (er) = child/son
哪儿 (nǎ er)  = where

Lesson 3[]

伦 (lún) = human relations/order
敦 (dūn) = kindhearted/place name
伦敦 (lúndūn) = London
台 (tái) = desk/table/counter
湾 (wān) = bay/gulf
台湾 (táiwān) = Taiwan
住 (zhù) = live

=== Skill 10 - Phrases_1 ===


Lesson 1[]

客 (kè) = customer/visitor/guest
气 (qì) = vital energy/air
不客气 (bù kè qì) = you're welcome
谢 (xiè) = to thank/thanks/ thank you
谢谢 (xiè xiè) = thank you

Lesson 2[]

起 (qǐ) = to rise/toraise/tostart/to get up
对不起 (duì bù qǐ) = sorry
没 (méi) = negative prefix for verbs) have not/
关 (guān) = to close/to concern/to involve
系 (xì) =  to connect/to relate to/to tie up/to bind
没关系 (méi guān xì) = no worries

=== Skill 11 - Family_1 ===


Lesson 1[]

爱 (ài) = love
爸爸 (bàbà) = father
妈 (mā) = mother/mum
妈妈 (māmā) = mother
家人 (jiā rén) = family

Lesson 2[]

个 (gè) = classifier - measure word
这 (zhè) = this/these
那 (nà) = that/those/then
谁 (shéi) = who

Lesson 3[]

有 (yǒu) = have/has
哥哥 (gēgē) = older brother
姐 (jiě) = older sister
姐姐 (jiějiě) = older sister

Lesson 4[]

和 (hé) = and/together with/sum
弟 (dì) = younger brother
弟弟 (dìdì) = younger brother
妹妹 (mèimèi) = younger sister
没 (méi) = no/not

=== Skill 12 - Phrases_2 ===


Lesson 1[]

知 (zhī) = to know/to be aware
道 (dào) = road/path/method/skill
知道 (zhī dào) = know/to become aware of
请 (qǐng) = please/to ask/to request
问 (wèn) = ask
请问 (qǐng wèn) = excuse me/may I ask

Lesson 2[]

语 (yǔ) = language
汉 (hàn) = Chinese
英语 (yīng yǔ) = English (language)
汉语 (hàn yǔ) = Chinese (language)
说 (shuō) = say/speak

Lesson 3[]

次 (cì) = time
一次 (yí cì) = once/one more time/again
帮 (bāng) = to help/to assist
助 (zhù) = to help/to assist
帮助 (bāng zhù) = help/assistance/aid
请 (qǐng) = please

=== Skill 13 - Greetings_4 ===


Lesson 1[]

会 (huì) = can/likely to/will/
一会儿 (yī huǐ er) = in a bit
安 (ān) = content/still/safe/secure
晚安 (wǎn ān) = good night/
早安 (zǎo ān) = good morning

Lesson 2[]

最 (zuì) = most/the most/- est
近 (jìn) = near/close to/ approximately
最近 (zuì jìn) = recently/these days
错 (cuò) = wrong
不错 (bù cuò) = not bad/pretty good
久 (jiǔ) = long time
好久不见 (hǎo jiǔ bù jiàn) = long time no see

=== Skill 14 - Drinks ===


Lesson 1[]

热 (rè) = hot
冰 (bīng) = ice/iced
要 (yào) = wants

Lesson 2[]

牛 (niú) = cow/ox/bull/awesome
奶 (nǎi) = breast milk/milk/
牛奶 (niú nǎi) = milk
咖 (kā) = coffee/class/grade
啡 (fēi) = (phonetic component) sounds lie English to me cafei
咖啡 (kā fēi) = coffee (loan word)

=== Skill 15 - Location_2 ===


Lesson 1[]

洗 (xǐ) = to wash
手 (shǒu) = hand/person working with skill
间 (jiān) = between/among/definte room
洗手间 (xǐ shǒu jiān) = bathroom
院 (yuàn) = institution/courtyard
医院 (yī yuàn) = hospital

Lesson 2[]

馆 (guǎn) = building/shop
饭馆 (fàn guǎn) = restaurant

=== Skill 16 - Time_1 ===


Lesson 1[]

号 (hào) = day of the month
月 (yuè) = month
年 (nián) = year
几 (jǐ) = how many

Lesson 2[]

星 (xīng) = star/small amount/satellite
期 (qī) =  a period of time/phase/stage
星期 (xīng qī) = week
明 (míng) = know/show/bright/immediately following in time
明天 (míng tiān) = tomorrow

Lesson 3[]

现 (xiàn) = now
点 (diǎn) = o'clock
半 (bàn) = half i.e. half past
几点 (jǐ diǎn) = what time

=== Skill 17 - Family_2 ===


Lesson 1[]

两 (liǎng) = two/both/some
两个 (liǎng gè) = two/both
孩 (hái) = child
子 (zǐ) = son
孩子 (hái zǐ) = children

Lesson 2[]

女 (nǚ) = woman/female
儿 (ér) = child
女儿 (nǚ ér) = daughter
儿子 (ér zǐ) = son
岁 (suì) = years old

Lesson 3[]

妻子 (qī zǐ) = wife
丈 (zhàng) = measure length/husband
夫 (fū) = husband/man/manual worker
丈夫 (zhàng fū) = husband

Lesson 4[]

狗 (gǒu) = dog
猫 (māo) = cat
它 (tā) = it

=== Skill 18 - Telephone ===


Lesson 1[]

喂 (wèi) = hello (on the phone)
慢 (màn) = slow/slowly

Lesson 2[]

得 (dé) = need/to get/to allow
快 (kuài) = fast
白 (bái) = blank/plain/clear
明白 (míng bái) = understand/obvious

=== Skill 19 - People_1 ===


Lesson 1[]

高 (gāo) = tall/high
漂 (piào) = to float/elegant/polished
亮 (liàng) = bright/clear/to show/to reveal
漂亮 (piào liàng) = beautiful/pretty

Lesson 2[]

朋 (péng) = friend
友 (yǒu) = friend
朋友 (péng yǒu) = friends
男 (nán) = boy/male
男朋友 (nán péng yǒu) = boyfriend
矮 (ǎi) = short

Lesson 3[]

女朋友 (nǚ péng yǒu) = girlfriend
非 (fēi) = not to be/wrong/incorrect
常 (cháng) = every/often/frequently
非常 (fēi cháng) = very much/unusual
可 (kě) = can/may/able
可爱 (kě ài) = cute/lovely

=== Skill 20 - Time_2 ===


Lesson 1[]

午 (wǔ) = 11 am - 1pm
上午 (shàng wǔ) = morning
下 (xià) = down/below/lower/later
下午 (xià wǔ) = afternoon
晚 (wǎn) = evening/night/late
晚上 (wǎn shàng) = evening/night
分 (fēn) = minutes

Lesson 2[]

周 (zhōu) = to circle/lap
末 (mò) = tip/end/final
周末 (zhōu mò) = weekend
每 (měi) = every
天 (tiān) = day
每天 (měi tiān) = every day

Lesson 3[]

昨 (zuó) = yesterday/the past
昨天 (zuó tiān) = yesterday
了 (le) = (interjection/perfective marker) - completed
上个 (shàng gè) = last/previous
做 (zuò) = did/do to do/to make/to produce

Lesson 4[]

去 (qù) =  to go/ to send/ to remove
会 (huì) = will
去年 (qù nián) = last year
下个 (xià gè) = next

=== Skill 21 - Location_3 ===


(3) 哪里， 那里， 这里 are interchangeable with words learned in previous lessons: 哪儿， 那儿， 这儿.[]


Lesson 1[]

右 (yòu) = right
边 (biān) = side
右边 (yòu biān) = right (direction)
左 (zuǒ) = left
左边 (zuǒ biān) = left (direction)
旁 (páng) = beside/one side/other
旁边 (páng biān) = next to/by/one side

Lesson 2[]

学校 (xué xiào) = school
前 (qián) = front
前面 (qián miàn) = front side
后 (hòu) = back/rear
后面 (hòu miàn) = behind

Lesson 3[]

到 (dào) = get/arrive/reach
走 (zǒu) = go
路 (lù) = the road/the route/the way

Lesson 4[]

往 (wǎng) = to/toward/towards
里 (lǐ) = lining/internal/inside
这里 (zhè lǐ) = here
那里 (nà lǐ) = there
在哪里 (zài nǎ lǐ) = where

=== Skill 22 - Hobbies_1 ===


Lesson 1[]

喜 (xǐ) = to be fond of/to like/to enjoy
欢 (huān) = joyous/happy/pleased
喜欢 (xǐ huān) = like/love/enjoy
看 (kàn) = read/reads/reading
书 (shū) = book/books
在 (zài) = right now (used before a verb)

Lesson 2[]

游 (yóu) = to do something
戏 (xì) = trick/drama/play/show
游戏 (yóu xì) = game/games
玩 (wán) = play/plays
脑 (nǎo) = brain/mind/head/essence
电脑 (diàn nǎo) = computer
最 (zuì) = most
最喜欢 (zuì xǐ huān) = favourite/most liked/most loved

Lesson 3[]

音 (yīn) = sound/noise/note/tone
音乐 (yīn yuè) = music
听 (tīng) = listen/listens
歌 (gē) = song/songs

Lesson 4[]

跳 (tiào) = to/jump/to/hop/to/skip
舞 (wǔ) = to dance/to wield/to brandish
跳舞 (tiào wǔ) = dance/dances
唱 (chàng) = to sing/chant/call loudly
唱歌 (chàng gē) = sing/sings/songs

=== Skill 23 - Routine_1 ===


Lesson 1[]

班 (bān) = class
上班 (shàng bān) = go to work
上学 (shàng xué) = go to school
起 (qǐ) = from
床 (chuáng) = bed
起床 (qǐ chuáng) = get up/gets up
早饭 (zǎo fàn) = breakfast
做 (zuò) = to do/to make/to write/to be
做饭 (zuò fàn) = cook/cooking

Lesson 2[]

睡觉 (shuì jiào) = go to sleep/bed
睡 (shuì) = sleep/to lie down
觉 (jiào) = a nap/to feel/to find
从 (cóng) = from
午饭 (wǔ fàn) = lunch

Lesson 3[]

回 (huí) = return/going back
放 (fàng) = finish e.g. finish school
放学（fàng xué）= to finish school for the day
晚饭 (wǎn fàn) = dinner
下班 (xià bān) = get/come off work

=== Skill 24 - Payment ===


Lesson 1[]

钱 (qián) = money
买 (mǎi) = buy/buys/buying
块 (kuài) = Yuan (Chinese currency)/dollar
只 (zhǐ) = only

Lesson 2[]

共 (gòng) = common/general/to share
一共 ( yī gòng) = altogether/in total
毛 (máo) = dime (one tenth of a dollar)
分 (fēn) = cent (one hundredth of a dollar)

Lesson 3[]

千 (qiān) = thousand
收 (shōu) = take/accept/accepted
信 (xìn) = letter/mail
用 (yòng) = to use/employ
卡 (kǎ) = card/to stop/
信用卡 (xìn yòng kǎ) = credit card

Lesson 4[]

金 (jīn) = gold
现金 (xiàn jīn) = cash
便 = plain/informal/suitable/convenienct
便宜 (pián yí) = cheap/small advantages/to let of lightly
贵 (guì) = expensive/noble/precious

Lesson 5[]

行 (xíng) = row/line/can (bu xíng - no way/ not ok)
万 (wàn) = ten thousand
太 (tài) = highest/very/so/too/large/vast

=== Skill 25 - Entertain ===


Lesson 1[]

视 (shì) = to look at/to regard/to inspect
电视 (diàn shì) = television.
影 (yǐng) = picture/image/film/movie
电影 (diàn yǐng) = movie
想 (xiǎng) = want to/would like to
干 (gàn) = do

Lesson 2[]

网 (wǎng) = net/network
上网 (shàng wǎng) = online
报 (bào) = to announce/inform/report/newspaper
纸 (zhǐ) = paper
报纸 (bào zhǐ) = newspaper

Lesson 3[]

新 (xīn) = new/newly
闻 (wén) = hear/news/famous
新闻 (xīn wén) = news
机 (jī) = engine/opportunity/flexible
手机 (shǒu jī) = mobile/cell phone
用 (yòng) = use

Lesson 4[]

目 (mù) = eye/item/section/list/title
节目 (jié mù) = programs/shows
体 (tǐ) = body/form/style
育 (yù) = to have children/bring up/to educate
体育 (tǐ yù) = sports
韩国 (hán guó) = Korea/Korean
明星 （míng	xīng）= star / celebrity

=== Skill 26 - Location_4 ===


Lesson 1[]

找 (zhǎo) = look/looking for/find
桌 (zhuō) = table / desk / classifier for tables of guests at a banquet etc
桌子 (zhuō zi) = table/desk
上 （shàng）= on
下 （xià）= under

Lesson 2[]

椅 (yǐ) = chair
椅子 (yǐ zi) = chair

Lesson 3[]

里 (lǐ) = in/inside/inner
外 (wài) = out/outside/outer
房 (fáng) = house/room
间 (jiān) = between/ among
房间 (fáng jiān) = room
箱 (xiāng) = box/trunk/chest
冰箱 (bīng xiāng) = fridge/refrigerator
学校 (xué xiào) = school

=== Skill 27 - Restaurant ===


Lesson 1[]

位 (wèi) = people (classifier)/position/place
进 (jìn) = come in/get in/enter
等 (děng) = wait/waiting

Lesson 2[]

英 (yīng) = English
文 (wén) = Language
英文 (yīng wén) = English language
菜 (cài) = dish/type of food/cuisine
单 (dān) = list form
菜单 (cài dān) = menu
坐 (zuò) = sit/to take a seat

Lesson 3[]

服 (fú) = clothes/dress/garment/to serve
务 (wù) = business/to attend to
员 (yuán) = person/employee/member
服务员 (fú wù yuán) = waiter/server
订 (dìng) = to order/to agree/to conclude/
订位 (dìng wèi) = book/order/reserve
菜 (cài) = type of food
点菜 (diǎn cài) = order
买单 (mǎi dān) = get the check/pay the bill

=== Skill 28 - Market ===


Lesson 1[]

东 (dōng) = landlord
西 (xī) = west/the West /Spain
东西 (dōng xī) = things/stuff/east and west/some
买东西 (mǎi dōng xī) = shopping/to do one's shopping (1)
些 (xiē)= some/few/several measure word for a small amount
一些 (yī xiē) = some/a few
帮 (bāng) = help

Lesson 2[]

超 (chāo) = to exceed/to overtake/to surpass/ultra
市 (shì) = market/city
超市 (chāo shì) = supermarket
果 (guǒ) = fruit/result/resolute/indeed/if really
水果 (shuǐ guǒ) = fruit

Lesson 3[]

瓜 (guā) = melon
西瓜 (xī guā) = watermelon
苹 (píng) = duckweed/clover fern/apple
苹果 (píng guǒ) = apple
给 (gěi) = give/to/for

Lesson 4[]

鲜 (xiān) =  fresh/bright/delivious/tasty
新鲜 (xīn xiān) = fresh(food)/freshness/uncommon
蔬 (shū) = vegetables
蔬菜 (shū cài) = vegetables/produce
鸡 (jī) = chicken
蛋 (dàn) = egg
鸡蛋 = (chicken) egg/eggs

Lesson 5[]

包 (bāo) = package/to include/to wrap
面包 (miàn bāo) = bread
糖 (táng) = sugar/sweets
米 (mǐ) = rice
袋 (dài) = bag/pouch/sack

=== Skill 29 - Hobbies_2 ===


Lesson 1[]

习 (xí) = to practice/tostudy/habit
学习 (xué xí) = learn/learning
文 (wén) = (written) language
中文 (zhōng wén) = Chinese
为 (wèi) = to act as/to save as/toserve as/
为什么 (wèi shén me) = why
去 (qù) = to/go to/get to

Lesson 2[]

所 (suǒ) = actually/place
以 (yǐ) = to/use/by means of/according to
所以 (suǒ yǐ) = and so
因 (yīn) = cause/reason/believe
西 (xī) = west
班 (bān) = class/shift/duty
牙 (yá) = tooth/ivory
西班牙 (xī bān yá) = Spain

Lesson 3[]

轻 (qīng) = light/easy/gentle/soft
松 (sōng) = loose/to loosen/to relax
轻松 (qīng sōng) = relax
旅 (lǚ) = trip/travel/brigade
旅游 (lǚ yóu) = travel
爱好 (ài hào) = hobby
西班牙语 (xī bān yá yǔ) = Spanish
新 (xīn) = new

Lesson 4[]

照 (zhào) = photo
照相 (zhào xiàng) = photography/taking pictures
照相机 (zhào xiàng jī) = camera
拍 (pāi) = to pat/to clap/to slap/to swat
拍照 pai zhao = to take a picture
印 (yìn) = to print/tomark/to engrave
度 (dù) = to pass/tospend time/to measure
印度 (yìn dù) = India
印度人 (yìn duó rén) = Indian (person)

=== Skill 30 - Dining_1 ===


Lesson 1[]

还是 hái shi= or
本 běn = root/stem/source
日本 (rì běn) = Japan
海 (hǎi) = ocean/sea/numerous
上海 (shàng hǎi) = Shanghai (city)
肉 (ròu) = meat
米饭 (mǐ fàn) = cooked rice
面条 (miàn tiáo) = noodles
鸡肉 (jī ròu)= chicken

Lesson 2[]

饮 (yǐn) = to  drink
料 (liào)= material/feed/guess
饮料 (yǐn liào) = drink/beverage
羊 (yáng) = lamb
羊肉 (yáng ròu) = mutton

Lesson 3[]

牛肉 (niú ròu) = beef
猪 (zhū) = pig
猪肉 (zhū ròu) = pork

=== Skill 31 - Health_1 ===


Lesson 1[]

工 (gōng) = Labour/Work
觉得 (juéde) = To feel/To think
作 (zuò) = To make/To work/To write
累 (lèi) = To tire/To be tired/Tired
有点 (yǒudiǎn) = Somewhat/A bit/A little
工作 (gōngzuò) = To work/To go to work

Lesson 2[]

健 (jiàn) = Healthy/Strong/Robust
胖 (pàng) = Fat
康 (kāng) = Peaceful/Healthy/Plentiful/Prosperous/Smooth/Empty
健康 (jiànkāng) = Healthy/Health
不要… (búyào) = Don’t.../Do not...

Lesson 3[]

注 zhù = to inject/to pay attention
意 yì =   Italy/idea/meaning/thought
注意 zhù yì =   to pay attention
身 shēn = body/life/onself
身体 shēn tǐ = the body/one's health

Lesson 4[]

开 (kāi) = To open/To start/To operate
始 (shǐ) = To begin/Begin
炼 (liàn) = To refine
锻 (duàn) = To forge/To temper
开始 (kāishǐ) = To start/To begin
锻炼 (duànliàn) = To work out/To exercise

=== Skill 32 - Transport ===


Lesson 1[]

站 zhàn = station, stand, stop
出租车 chū zū chē = taxi
出 chū = to go out/to happen
租 zū = to hire/to rent/to charter
车 chē = car/vehicle
地铁 dì tiě = subway/metro/underground
店 diàn = inn/shop/store
酒 jiǔ = wine/rice wine/spirits
酒店 jiǔ diàn = wine shop/pub/hotel

Lesson 2[]

汽 qì = steam/vapour
船 chuán = boat/ship/vessell
公共 gōng gòng = public/common/communal
可以 kě yǐ = can/may/possible
汽车 qì chē = car/automobile/bus

Lesson 3[]

准 zhǔn = allow/grant

Lesson 4[]


=== Skill 33 - Shopping_1 ===


Lesson 1[]

衣服 yī fu   =  clothes
商店  shāng diàn  =  shop/store
件 jiàn  =  item/things/clothes/classifier

Lesson 2[]

门 mén  =  gate/door/opening
迎 yíng  =  welcome/to meet
关 guān  =  to close/to shut
欢迎 huān yíng  =  welcome/
帮忙 bāng máng  =  to help/lend a hand
需要 xū yào   =  to/need/to require

Lesson 3[]

您 nín  =  you (courteous)
随便 suí biàn  =  as you wish
随 suí  =  to comply

=== Skill 34 - Languages_1 ===


Lesson 1[]

字 (zì) =  letter/character/symbol
难 (nán)  = difficult/problem
思 (sī) =  to think/to consider
意思 (yìsī) = meaning
写 (xiě) = to write
读 （dú）= to read

=== Skill 35 - Time_3 ===

刻 kè =  a quarter (hour)/short time intervals
秒 miǎo = a second/ instantly
差 chā  = difference/differ from
整 zhěng = exactly/in good order
小时 xiǎo shí = hour
分钟 fēn zhōng = minute
时 时 = time/period
等  děng  =  wait
整  zhěng  =  exactly
钟  zhōng  =  time in hours

=== Skill 36 - Dining_2 ===

杯 bēi. =  cup, glass,
块 kuài =  piece (a measure word)
碗 wǎn  =  bowl

=== Skill 37 - Existence ===

本 běn = measure word for magazines, books, notebook
zhang = measure word for flat objects
Zhi = measure word for animals
辆 liàng = classifier for vehicles
=  there is/are there is/are not
办  bàn = to do/to measure/to handle
室  shì = room/work kit/grave
汽车  qì chē = car/bus

=== Skill 38 - Sports_1 ===



=== Skill 39 - Invite_1 ===


Lesson 1[]

吧 (ba) = particle used to indicate suggestion
没有 (méi yǒu)= to not have/ haven't/ hasn't
有 (yǒu) = To have/ to posses
有没有 (yǒu méi yǒu) = Do you have.....
出去 (chū qù) = To go out[1]

Lesson 2[]


Lesson 3[]


Lesson 4[]


Lesson 5[]


=== Skill 40 - Health_2 ===


Lesson 1[]


Lesson 2[]


Lesson 3[]


Lesson 4[]


Lesson 5[]


=== Skill 41 - Invite_2 ===


Lesson 1[]


Lesson 2[]


Lesson 3[]


Lesson 4[]


Lesson 5[]


=== Skill 42 - Dining_3 ===


Lesson 1[]


Lesson 2[]


Lesson 3[]


Lesson 4[]


Lesson 5[]


=== Skill 43 - Shopping_2 ===


Lesson 1[]


Lesson 2[]


Lesson 3[]


Lesson 4[]


Lesson 5[]


=== Skill 44 - Body_Parts ===


Lesson 1[]


Lesson 2[]


Lesson 3[]


Lesson 4[]


=== Skill 45 - Travel ===


Lesson 1[]


Lesson 2[]


Lesson 3[]


Lesson 4[]


Lesson 5[]


=== Skill 46 - Weather ===


Lesson 1[]


Lesson 2[]


Lesson 3[]


Lesson 4[]


Lesson 5[]


Lesson 6[]


=== Skill 47 - Shopping_3 ===


Lesson 1[]


Lesson 2[]


Lesson 3[]


Lesson 4[]


Lesson 5[]


=== Skill 48 - People_2 ===


Lesson 1[]


Lesson 2[]


Lesson 3[]


Lesson 4[]


=== Skill 49 - Celebrate ===


Lesson 1[]


Lesson 2[]


Lesson 3[]


Lesson 4[]


=== Skill 50 - Sports_2 ===


Lesson 1[]

练 (liàn) = to practice/to train
赛 (sài) = game/match/competition
课 (kè) = class/lesson
懂 (dǒng) = understand/know
乒乓 (pīng pāng) = ping pong

Lesson 2[]

第 (dì) = ordinal number marker
排 (pái) = row
参加 (cān jiā) = participate/take part
加油 (jiā yóu) = come on

Lesson 3[]

赢 (yíng) = win
输 (shū) = lose
信心 (xìn xīn) = confidence/faith
失望 (shī wàng) = be disappointed

=== Skill 51 - School ===


Lesson 1[]

课 (kè) = class/lesson
理 (lǐ) = reason
同学 (tóng xué) = classmate/schoolmate
教室 (jiào shì) = classroom/schoolroom

Lesson 2[]

懂 (dǒng) = understand/know
笔 (bǐ) = pen/pencil
美术 (měi shù) = art
问题 (wèn tí) = question/problem/issue

Lesson 3[]

考试 (kǎo shì) = examination/exam/test
准备 (zhǔn bèi) = prepare/ready
科学 (kē xué) = science

=== Skill 52 - Family_3 ===


Lesson 1[]

奶奶 (nǎi nǎi) = grandma
爷爷 (yé yé) = grandpa
阿姨 (ā yí) = aunt

Lesson 2[]

兄弟姐妹 (xiōng dì jiě mèi) = siblings
关系 (guān xì) = relationship
叔叔 (shū shū) = uncle
父母 (fù mǔ) = parents

Lesson 3[]

亲戚 (qīn qī) = relatives
像 (xiàng) = as
一样 (yī yàng) = same/as/look like

=== Skill 53 - Duo ===


Lesson 1[]

多儿 (duō ér) = Duo
橙 (chéng) = orange
羽毛 (yǔ máo) = feathers
猫头鹰 (māo tóu yīng) = owl

Lesson 2[]

放弃 (fàng qì) = give up
提醒 (tí xǐng) = remind
懒 (lǎn) = lazy
鼓励 (gǔ lì) = encourage

